###                 #########
#   ###################   # #
# ####                # # # #
# ################### # # # #
#                     # # # #
###########B######### # # # #
#   ##                # # # #
# # ## ### ## ######### # # #
# #    #   ## #         # # #
# # ## ################ # # #
### ##             #### # # #
### ############## ## # # # #
###             ##    # # # #
########### ### ####### # # #
###########             #   #
###     ###A#################
